16 15
################
#              #
#              #
#              #
#              #
#              #
#              #
#2            1#
#              #
#              #
#              #
#              #
#              #
#              #
################
