20 14
####################
#          #       #
#          #       #
#         ##       #
#         #        #
#       ###        #
#      1#          #
#     #2           #
#    ##            #
#   ##             #
## ##              #
## #               #
#  #               #
####################
